40
30
24 26 26 26 26 26 26 26 26 26 26 26 26 26 26 26 26 26 26 26 26 26 26 26 26 26 26 26 26 26 26 26 26 26 26 26 26 26 26 26 
24 3 3 3 3 3 3 3 3 3 3 3 3 3 3 3 3 3 3 3 3 3 3 3 3 3 3 3 3 3 3 3 3 3 3 3 3 3 3 22 
24 3 3 3 3 3 3 3 3 3 3 3 3 3 3 3 3 3 3 3 3 3 3 3 3 3 3 3 3 3 3 3 3 3 3 3 3 3 3 22 
24 3 3 3 3 3 3 3 3 3 3 3 3 3 3 3 3 3 3 3 3 3 3 3 3 3 3 3 3 3 3 3 3 3 3 3 3 3 3 22 
24 3 3 3 3 3 3 3 3 3 3 3 3 3 3 3 3 3 3 3 3 3 3 3 3 3 3 3 3 3 3 3 3 3 3 3 3 3 3 22 
24 3 3 3 3 3 3 3 3 3 3 3 3 3 3 3 3 3 3 3 3 3 3 3 3 3 3 3 3 3 3 3 3 3 3 3 3 3 3 22 
24 3 3 3 3 3 3 3 3 3 3 3 3 3 3 3 3 3 3 3 3 3 3 3 3 3 3 3 3 3 3 3 3 3 3 3 3 3 3 22 
24 3 3 3 3 3 3 3 3 3 3 3 3 3 3 3 3 3 3 3 3 3 3 3 3 3 3 3 3 3 3 3 3 3 3 3 3 3 3 22 
24 3 3 3 3 3 3 3 3 3 3 3 3 3 3 3 3 3 3 3 3 3 3 3 3 3 3 3 3 3 3 3 3 3 3 3 3 3 3 22 
24 3 3 3 3 3 3 3 3 3 3 3 3 3 3 3 3 3 3 3 3 3 3 3 3 3 3 3 3 3 3 3 3 3 3 3 3 3 3 22 
24 3 3 3 3 3 3 3 3 3 3 3 3 3 3 3 3 3 3 3 3 19 20 20 20 20 20 21 3 3 3 3 3 3 3 3 3 3 3 22 
24 3 3 3 3 3 3 3 3 3 3 3 3 3 3 3 3 3 3 3 3 22 23 23 23 23 23 24 3 3 3 3 3 3 3 3 3 3 3 22 
24 3 3 3 3 3 3 3 3 3 3 3 3 3 3 3 3 3 3 3 3 22 23 23 23 23 23 24 3 3 3 3 3 3 3 3 3 3 3 22 
24 3 3 2 2 2 2 2 2 2 2 2 2 2 2 3 3 3 3 3 3 22 23 23 23 23 23 24 3 3 3 3 3 3 3 3 3 3 3 22 
24 3 3 2 2 2 2 1 1 1 2 2 2 2 2 3 3 3 3 3 3 22 23 23 23 23 23 24 3 3 3 3 3 3 3 3 3 3 3 22 
24 3 3 2 2 2 2 1 1 1 2 2 2 2 2 3 3 3 3 3 3 22 23 23 23 23 23 24 3 3 3 3 3 3 3 3 3 3 3 22 
24 3 3 2 2 2 2 2 2 2 2 2 2 2 2 3 3 3 3 3 3 22 23 23 23 23 23 24 3 3 3 3 3 3 3 3 3 3 3 3 
24 3 3 2 2 2 28 29 29 29 30 2 2 2 2 3 3 3 3 3 3 22 23 23 23 23 23 24 3 3 3 3 3 3 3 3 3 3 3 22 
24 3 3 2 2 2 34 35 35 35 36 2 2 2 2 3 3 3 3 3 3 22 23 23 23 23 23 24 3 3 3 3 3 3 3 3 3 3 3 22 
24 3 3 2 2 2 2 2 2 2 2 2 2 2 2 3 3 3 3 3 3 22 23 23 23 23 23 24 3 3 3 3 3 3 3 3 3 3 3 22 
24 3 3 3 3 3 3 3 3 3 3 3 3 3 3 3 3 3 3 3 3 22 23 23 23 23 23 24 3 3 3 3 3 3 3 3 3 3 3 22 
24 3 3 3 3 3 3 3 3 3 3 3 3 3 3 3 3 3 3 3 3 22 23 23 23 23 23 24 3 3 3 3 3 3 3 3 3 3 3 22 
24 3 3 3 3 3 3 3 3 3 3 3 3 3 3 3 3 3 3 3 3 25 26 26 26 26 26 27 3 3 3 3 3 3 3 3 3 3 3 22 
24 3 3 3 3 3 3 3 3 3 3 3 3 3 3 3 3 3 3 3 3 3 3 3 3 3 3 3 3 3 3 3 3 3 3 3 3 3 3 22 
24 3 3 3 3 3 3 3 3 3 3 3 3 3 3 3 3 3 3 3 3 3 3 19 21 3 3 3 3 3 3 3 3 3 3 3 3 3 3 22 
24 3 3 3 3 3 3 3 3 3 3 3 3 3 3 3 3 3 3 3 3 3 3 25 27 3 3 3 3 3 3 3 3 3 3 3 3 3 3 22 
24 3 3 3 3 3 3 3 3 3 3 3 3 3 3 3 3 3 3 3 3 3 3 3 3 3 3 3 3 3 3 3 3 3 3 3 3 3 3 22 
24 3 3 3 3 3 3 3 3 3 3 3 3 3 3 3 3 3 3 3 3 3 3 3 3 3 3 3 3 3 3 3 3 3 3 3 3 3 3 22 
24 3 3 3 3 3 3 3 3 3 3 3 3 3 3 3 3 3 3 3 3 3 3 3 3 3 3 3 3 3 3 3 3 3 3 3 3 3 3 22 
20 20 20 20 20 20 20 20 20 20 20 20 20 20 20 20 20 20 20 20 20 20 20 20 20 20 20 20 20 20 20 20 20 20 20 20 20 20 20 22

