40
30
18 18 18 18 18 18 18 18 18 18 18 18 18 18 18 18 18 18 18 18 18 18 18 18 18 18 18 18 18 18 18 18 18 18 18 18 18 18 18 18
18 2 2 2 2 2 2 2 2 2 2 2 2 2 2 2 2 2 2 2 2 2 2 2 2 18 19 19 19 20 2 2 2 2 2 2 2 2 2 18
18 2 2 2 2 2 2 2 2 2 2 2 2 2 2 2 2 2 2 2 2 2 2 2 2 21 22 22 22 23 2 2 2 2 2 2 2 2 2 18
18 2 2 2 2 2 2 2 2 2 2 2 2 2 2 2 2 2 2 2 2 2 2 2 2 21 22 22 22 23 2 2 2 2 2 2 2 2 2 18
18 2 2 2 2 2 2 2 2 2 2 2 2 2 2 2 2 2 2 2 2 2 2 2 2 21 22 22 22 23 2 2 2 2 2 2 2 2 2 18
18 2 2 2 2 2 2 2 2 2 2 2 2 2 2 2 2 2 2 2 2 2 2 2 2 21 22 22 22 23 2 2 2 2 2 2 2 2 2 18
18 2 2 2 2 2 2 2 2 2 2 2 2 2 2 2 2 2 2 2 2 2 2 2 2 21 22 22 22 23 2 2 2 2 2 2 2 2 2 18
18 2 2 2 2 2 2 2 2 2 2 2 2 2 2 2 2 2 2 2 2 2 2 2 2 21 22 22 22 23 2 2 2 2 2 2 2 2 2 18
18 2 2 2 2 2 2 2 2 2 2 2 2 18 18 18 18 18 2 2 2 2 2 2 2 21 22 22 22 23 2 2 2 2 2 2 2 2 2 18
18 2 2 2 2 2 2 2 2 2 2 2 2 18 18 18 18 18 2 2 2 2 2 2 2 21 22 22 22 23 2 2 2 2 2 2 2 2 2 18
18 2 2 2 2 2 2 2 2 2 2 2 2 2 2 2 2 2 2 2 2 2 2 2 2 21 22 22 22 23 2 2 2 2 2 2 2 2 2 18
18 2 2 2 2 2 2 2 2 2 2 2 2 2 2 2 2 2 2 2 2 2 2 2 2 21 22 22 22 23 2 2 2 2 2 2 2 2 2 18
18 2 2 2 2 2 2 2 2 2 2 2 2 2 2 2 2 2 2 2 2 2 2 2 2 21 22 22 22 23 2 2 2 2 2 2 2 2 2 18
18 2 2 2 2 2 2 2 2 2 2 2 2 2 2 2 2 2 2 2 2 2 2 2 2 21 22 22 22 23 2 2 2 2 2 2 2 2 2 18
18 2 2 2 2 2 2 2 2 2 2 2 2 2 2 2 2 2 2 2 2 2 2 2 2 21 22 22 22 23 2 2 2 2 2 2 2 2 2 18
18 2 2 2 2 2 2 2 2 2 2 2 2 2 2 2 2 2 2 2 2 2 2 2 2 21 22 22 22 23 2 2 2 2 2 2 2 2 2 18
18 2 2 2 2 2 2 2 2 2 2 2 2 2 2 2 2 2 2 2 2 2 2 2 2 21 22 22 22 23 2 2 2 2 2 2 2 2 2 18
18 2 2 2 2 2 2 2 2 2 2 2 2 2 2 2 2 2 2 2 2 2 2 2 2 21 22 22 22 23 2 2 2 2 2 2 2 2 2 18
18 2 2 2 2 2 2 2 2 2 2 2 2 2 2 2 2 2 2 2 2 2 2 2 2 24 25 25 25 26 2 2 2 2 2 2 2 2 2 18
18 2 2 2 2 2 2 2 2 2 2 2 2 2 2 2 2 2 2 2 2 2 2 2 2 2 2 2 2 2 2 2 2 2 2 2 2 2 2 2
18 2 2 2 2 2 2 2 2 2 2 2 2 2 2 2 2 2 2 2 2 2 2 2 2 18 19 19 19 20 2 2 2 2 2 2 2 2 2 18
18 2 2 2 2 2 2 2 2 2 2 2 2 2 2 2 2 2 2 2 2 2 2 2 2 21 22 22 22 23 2 2 2 2 2 2 2 2 2 18
18 2 2 2 2 2 2 2 2 2 2 2 2 2 2 2 2 2 2 2 2 2 2 2 2 21 22 22 22 23 2 2 2 2 2 2 2 2 2 18
18 2 2 2 2 2 2 2 2 2 2 2 2 2 2 2 2 2 2 2 2 2 2 2 2 21 22 22 22 23 2 2 2 2 2 2 2 2 2 18
18 2 2 2 2 2 2 2 2 2 2 2 2 2 2 2 2 2 2 2 2 2 2 2 2 21 22 22 22 23 2 2 2 2 2 2 2 2 2 18
18 2 2 2 2 2 2 2 2 2 2 2 2 2 2 2 2 2 2 2 2 2 2 2 2 21 22 22 22 23 2 2 2 2 2 2 2 2 2 18
18 2 2 2 2 2 2 2 2 2 2 2 2 2 2 2 2 2 2 2 2 2 2 2 2 21 22 22 22 23 2 2 2 2 2 2 2 2 2 18
18 2 2 2 2 2 2 2 2 2 2 2 2 2 2 2 2 2 2 2 2 2 2 2 2 21 22 22 22 23 2 2 2 2 2 2 2 2 2 18
18 2 2 2 2 2 2 2 2 2 2 2 2 2 2 2 2 2 2 2 2 2 2 2 2 21 22 22 22 23 2 2 2 2 2 2 2 2 2 18
18 18 18 18 18 18 18 18 18 18 18 18 18 18 18 18 18 18 18 18 18 18 18 18 18 21 22 22 22 23 18 18 18 18 18 18 18 18 18 18
 
