20
40
45 49 49 49 49 49 49 49 49 49 49 49 49 49 49 49 49 49 49 46 
50 3 3 3 3 3 3 3 3 3 3 3 3 3 3 3 3 3 3 50 
50 3 3 3 3 3 3 3 3 3 3 3 3 3 3 3 3 3 3 50 
50 3 3 3 3 3 3 3 3 3 3 3 3 3 3 3 3 3 3 50 
50 3 3 3 3 3 3 3 3 3 3 3 3 3 3 3 3 3 3 50 
50 3 3 3 3 3 3 3 3 3 3 3 3 3 3 3 3 3 3 50 
50 3 3 3 3 37 38 39 3 3 3 3 3 3 3 3 3 3 3 50 
50 3 3 3 3 40 41 42 3 3 3 28 29 29 29 29 30 3 3 50 
50 3 3 3 3 43 55 44 3 3 3 31 32 32 32 32 33 3 3 50 
1 1 2 1 2 1 1 3 3 3 3 31 32 32 32 32 33 3 3 50 
50 3 3 3 3 3 1 3 3 3 3 34 35 35 35 35 36 3 3 50 
50 3 3 3 3 3 1 1 1 1 2 1 1 2 2 1 2 3 3 50 
50 3 3 3 3 3 3 3 3 3 3 3 3 3 3 3 3 3 3 50 
50 3 3 3 3 3 3 3 3 3 3 3 3 3 3 3 3 3 3 50 
50 3 3 3 3 3 3 3 3 3 3 3 3 3 3 3 3 3 3 50 
50 3 3 3 3 3 3 3 3 3 3 3 3 3 3 3 3 3 3 50 
50 3 3 3 3 3 3 3 3 3 3 3 3 3 3 3 3 3 3 50 
50 3 3 3 3 3 3 3 3 3 3 3 3 3 3 3 3 3 3 50 
50 3 3 3 3 3 3 3 3 3 3 3 3 3 3 3 3 3 3 50 
50 3 3 3 3 3 3 3 3 3 3 3 3 3 3 3 3 3 3 50 
47 49 49 49 49 49 49 49 49 49 49 49 49 49 49 46 3 45 49 48 
45 49 49 49 49 49 49 49 49 49 49 49 49 49 49 48 3 50 3 50 
50 3 3 3 3 3 3 3 3 3 3 3 3 3 3 3 3 50 3 50 
50 3 45 49 49 49 49 49 49 49 49 49 46 3 45 49 49 48 3 50 
50 3 50 45 49 49 49 49 49 49 49 49 48 3 50 3 50 3 3 50 
50 3 50 50 3 3 3 3 3 3 3 3 3 3 50 3 50 3 3 50 
50 3 50 50 3 49 49 49 49 49 49 49 49 49 48 3 50 3 3 50 
50 3 50 50 3 3 3 3 3 3 3 3 3 3 3 3 50 3 3 50 
50 3 50 47 49 46 3 45 49 49 49 49 49 49 49 49 48 3 3 50 
50 3 47 49 46 50 3 50 3 3 3 3 50 19 20 21 3 3 3 50 
50 3 3 3 50 50 3 3 3 3 3 3 50 25 26 27 3 3 3 50 
50 3 50 3 50 47 49 49 49 49 49 49 48 49 49 49 49 46 3 50 
50 3 50 3 50 3 3 3 3 3 3 3 3 3 50 3 3 50 3 50 
50 3 50 3 47 49 49 49 49 49 49 49 49 3 50 3 3 50 3 50 
50 3 50 3 3 3 3 3 3 3 3 3 3 3 50 3 3 50 3 50 
50 3 47 49 49 49 49 49 49 49 49 49 49 49 48 3 3 50 3 50 
50 3 3 3 3 3 3 3 3 3 3 3 3 3 3 3 3 50 3 50 
50 3 49 49 49 49 49 49 49 49 49 49 49 49 49 49 49 48 3 50 
50 3 3 3 3 3 3 3 3 3 3 3 3 3 3 3 3 3 3 50 
47 49 49 49 49 49 49 49 49 49 49 49 49 49 49 49 49 49 49 48

